{
  "version": 1,
  "id": "default_archipelago_large",
  "name": "Arcipelago iniziale grande",
  "width": 128,
  "height": 80,
  "legend": {
    "~": "Water",
    ".": "Land",
    "F": "Forest",
    "M": "Mountain",
    "C": "Cloud"
  },
  "rows": [
    "~~~~~~~~~~~~~~~~~~~~~~~~~~~~~~~~~~~~~~~~~~~~~~~~~~~~~~~~~~~~~~~~~~~~~~~~~~~~~~~~~~~~~~~~~~~~~~~~~~~~~~~~~~~~~~~~~~~~~~~~~~~~~~~~",
    "~~~~~~~~~~~~~~~~~~~~~~~~~~~~~~~~~~~~~~~~~~~~~~~~~~~~~~~~~~~~~~~~~~~~~~~~~~~~~~~~~~~~~~~~~~~~~~~~~~~~~~~~~~~~~~~~~~~~~~~~~~~~~~~~",
    "~~~~~~~~~~~~~~~~~~~~~~~~~~~~~~~~~~~~~~~~~~~~~~~~~~~~~~~~~~~~~~~~~~~~~~~~~~~~~~~~~~~~~~~~~~~~~~~~~~~~~~~~~~~~~~~~~~~~~~~~~~~~~~~~",
    "~~~~~~~~~~~~~~~~~~~~~~~~~~~~~~~~~~~~~~~~~~~~~~~~~~~~~~~~~~~~~~~~~~~~~~~~~~~~~~~~~~~~~~~~~~~~~~~~~~~~~~~~~~~~~~~~~~~~~~~~~~~~~~~~",
    "~~~~~~~~~~~~~~~~~~~~~~~~~~~~~~~~~~~~~~~~~~~~~~~~~~~~~~~~~~~~~~~~~~~~~~~~~~~~~~~~~~~~~~~~~~~~~~~~~~~~~~~~~~~~~~~~~~~~~~~~~~~~~~~~",
    "~~~~~~~~~~~~~~~~~~~~~~~~~~~~~~~~~~~~~~~~~~~~~~~~~~~~~~~~~~~~~~~~~~~~~~~~~~~~~~~~~~~~~~~~~~~~~~~~~~~~~~~~~~~~~~~~~~~~~~~~~~~~~~~~",
    "~~~~~~~~~~~~~~~~~~~~~~~~~~~~~~~~~~~~~~~~~~~~~~~~~~~~~~~~~~~~~~~~~~~~~~~~~~~~~~~~~~~~~~~~~~~~~~~~~~C~~~~~~~~~~~~~~~~~~~~~~~~~~~~~",
    "~~~~~~~~~~~~~~~~~~~~~~~~~~~~~~~~~~~~~~~~~~~~~~~~~~~~~~~~~~~~~~~~~~~~~~~~~~~~~~~~~~~~~~~~~~~~~~~CCCCCC~C~~~~~~~~~~~~~~~~~~~~~~~~~",
    "~~~~~~~~~~~~~~~~~~~~~~~~~~~~~~~~~~~~~~~~~~~~~~~~~~~~~~~~~~~~~~~~~~CCC~~~~~~~~~~~~~~~~~~~~~~~~~CCCCCCCCCCCCCC~~~~~~~~~~~~~~~~~~~~",
    "~~~~~~~~~~~~~~~~~~~~~~~~~~~~~~~~~~~~~~~~~~~~~~~~~~~~~~~~~~~~CCCCCCCCCC~~~~~~~~~~~~~~~~~~~~~~CCCCCCCCCCCCCCCCC~~~~~~~~~~~~~~~~~~~",
    "~~~~~~~~~~~~~~~~~~~~~~~~~~~~~~~~C~~~~~~~~~~~~~~~~~~~~~~CCCCCCCCCCCCCCCC~~~~~~~~~~~~~~~CCCCCCCCCCCCCCCCCCCCCCCC~~~~~~~~~~~~~~~~~~",
    "~~~~~~~~~~~~~~~~~~~~~~~~~~~~~CCCCCC~~~~~~~~~~~~~~~~~~~CCCCCCCCCCCCCCCCCC~~~~~~~~~~~~~CCCCCCCCCCCCCCCCCCCCCCCCC~~~~~~~~~~~~~~~~~~",
    "~~~~~~~~~~~~~~~~~~~~~~~CCCCCCCCCCCCC~~~~~~~~~~~~~~~~~~CCCCCCCCCCCCCCCCCCC~~~~~~~~~~~CCCCCCCCCCCCCCCCCCCCCCCCCC~~~~~~~~~~~~~~~~~~",
    "~~~~~~~~~~~~~~~~~~~~~~CCCCCCCCCCCCCCCCCC~~~~~~~~~~~~~CCCCCCCCCCCCCCCCCCCC~~~~~~~~~~CCCCCCCCCCCCCCCCCCCCCCCCCCCC~~~~~~~~~~~~~~~~~",
    "~~~~~~~~~~~~~~~~~~~~~CCCCCCCCCCCCCCCCCCCCC~~~~~~~~~~~CCCCCCCCCCCCCCCCCCCC~~~~~~~~~CCCCCCCCCCCCCCCCCCCCCCCCCCCCCCC~~~~~~~~~~~~~~~",
    "~~~~~~~~~~~~~~~~~~~CCCCCCCCCCCCCCCCCCCCCCCCC~~~~~~~~~~CCCCCCCCCCCCCCCCCCC~~~~~~~~~CCCCCCCCCCCCCCCCCCCCCCCCCCCCCCCC~~~~~~~~~~~~~~",
    "~~~~~~~~~~~~~~~~~CCCCCCCCCCCCCCCCCCCCCCCCCCCC~~~~~~~~~CCCCCCCCCCCCCCCCCC~~~~~~~~~CCCCCCCCCCCCCCCCCCCCCCCCCCCCCCCCCC~~~~~~~~~~~~~",
    "~~~~~~~~~~~~~~~CCCCCCCCCCCCCCCCCCCCCCCCCCCCCC~~~~~~~~~CCCCCCCCCCCCCCCC~~~~~~~~~~~CCCCCCCCCCCCCCCCCCCCCCCCCCCCCCCCCCC~~~~~~~~~~~~",
    "~~~~~~~~~~~~~~CCCCCCCCCCCCCCCCCCCCCCCCCCCCCCCC~~~~~~~~~~CCCCCCCCCCCCCC~~~~~~~~~~~CCCCCCCCCCCCCCCCCCCCCCCCCCCCCCCCCCCC~~~~~~~~~~~",
    "~~~~~~~~~~~~~CCCCCCCCCCCCCCCCCCCCCCCCCCCCCCCCC~~~~~~~~~~~~~~CCCCCCCCC~~~~~~~~~~~CCCCCCCCCCCCCCCCCCCCCCCCCCCCCCCCCCCC~~~~~~~~~~~~",
    "~~~~~~~~~~~~~CCCCCCCCCCCCCCCCCCCCCCCCCCCCCCCCC~~~~~~~~~~~~~~~~CCCCC~~~~~~~~~~~~~CCCCCCCCCCCCCCCCCCCCCCCCCCCCCCCCCCCCC~~~~~~~~~~~",
    "~~~~~~~~~~~~~CCCCCCCCCCCCCCCCCCCCCCCCCCCCCCCCCC~~~~~~~~~~~~~~~~~~~~~~~~~~~~~~~~~CCCCCCCCCCCCCCCCCCCCCCCCCCCCCCCCCCCCC~~~~~~~~~~~",
    "~~~~~~~~~~~~~CCCCCCCCCCCCCCCCCCCCCCCCCCCCCCCCCC~~~~~~~~~~~~~~~~~~~~~~~~~~~~~~~~~CCCCCCCCCCCCCCCCCCCCCCCCCCCCCCCCCCCC~~~~~~~~~~~~",
    "~~~~~~~~~~~~~CCCCCCCCCCCCCCCCCCCCCCCCCCCCCCCCCC~~~~~~~~~~~~~~~~~~~~~~~~~~~~~~~~~CCCCCCCCCCCCCCCCCCCCCCCCCCCCCCCCCCC~~~~~~~~~~~~~",
    "~~~~~~~~~~~~~~CCCCCCCCCCCCCCCCCCCCCCCCCCCCCCCCC~~~~~~~~~~~~~~~~~~~~~~~~~~~~~~~~~~CCCCCCCCCCCCCCCCCCCCCCCCCCCCCCCCC~~~~~~~~~~~~~~",
    "~~~~~~~~~~~~~~~CCCCCCCCCCCCCCCCCCCCCCCCCCCCCCC~~~~~~~~~~~~~~~~~~~~~~~~~~~~~~~~~~~~CCCCCCCCCCCCCCCCCCCCCCCCCCCCCCC~~~~~~~~~~~~~~~",
    "~~~~~~~~~~~~~~~~~CCCCCCCCCCCCCCCCCCCCCCCCCCCCC~~~~~~~~~~~~~~~~~~~~~~~~~~~~~~~~~~~~~~CCCCCCCCCCCCCCCCCCCCCCCCCCC~~~~~~~~~~~~~~~~~",
    "~~~~~~~~~~~~~~~~~~~CCCCCCCCCCCCCCCCCCCCCCCCC~~~~~~~~~~~~~~~~~~~~~~~~~~~~~~~~~~~~~~~~~~~~~~CCCCCCCCCCCCCCCCCCCC~~~~~~~~~~~~~~~~~~",
    "~~~~~~~~~~~~~~~~~~~~~CCCCCCC~~CCCCCCCCCC~~~~~~~~~~~~~~~~~~~~~~~~~~~~~~~~~~~~~~~~~~~~~~~~~~~~~CCCCC~~CCCCCCCCC~~~~~~~~~~~~~~~~~~~",
    "~~~~~~~~~~~~~~~~~~~~~~~C~~~~~~~~~~~~~~~~~~~~~~~~~~~~~~~~~~~~~.~~~~~~~~~~~~~~~~~~~~~~~~~~~~~~~~~~~~~~~~~~CC~~~~~~~~~~~~~~~~~~~~~~",
    "~~~~~~~~~~~~~~~~~~~~~~~~~~~~~~~~~~~~~~~~~~~~~~~~~~~~~~~~~~~....F..~~~~~~~~~~~~~~~~~~~~~~~~~~~~~~~~~~~~~~~~~~~~~~~~~~~~~~~~~~~~~~",
    "~~~~~~~~~~~~~~~~~~~~~~~~~~~~~~~~~~~~~~~~~~~~~~~~~~~~~~~~~~FFF.....MMF.~~~~~~~~~~~~~~~~~~~~~~~~~~~~~~~~~~~~~~~~~~~~~~~~~~~~~~~~~~",
    "~~~~~~~~~~~~~~~~~~~~~~~~~~~~~~~~~~~~~~~~~~~~~~~~~~~~~~~~~F.F.F.F..F.FF..~~~~~~~~~~~~~~~~~~~~~~~~~~~~~~~~~~~~~~~~~~~~~~~~~~~~~~~~",
    "~~~~~~~~~~~~~~~~~~~~~~~~~~~~~~~~~~~~~~~~~~~~~~~~~~~~~~~~.FFFFF..........~~~~~~~~~~~~~~~~~~~~~~~~~~~~~~~~~~~~~~~~~CC~~~~~~~~~~~~~",
    "~~~~~~~~~CCCCCCCCCCC~~~~~~~~~~~~~~~~~~~~~~~~~~~~~~~~~.....MM.F....F..F....~~~~~~~~~~~~~~~~~~~~~~~~~~~~~~~~~~~~CCCCCCCCCC~~~~~~~~",
    "~~~~~~~~CCCCCCCCCCCCC~~~~~~~~~~~~~~~~~~~~~~~~~~~~~~~.FF.....MF....F.......F..~~~~~~~~~~~~~~~~~~~~~~~~~~~~~~~CCCCCCCCCCCCCC~~~~~~",
    "~~~~~~~~CCCCCCCCCCCCC~~~~~~~~~~~~~~~~~~~~~~~~~~~~~~.F.FF.....M...FFF.....F....~~~~~~~~~~~~~~~~~~~~~~~~~~~~~~CCCCCCCCCCCCCCCC~~~~",
    "~~~~~~~~CCCCCCCCCCCCC~~~~~~~~~~~~~~~~~~~~~~~~~~~~~...F..FM.....................~~~~~~~~~~~~~~~~~~~~~~~~~~~~~CCCCCCCCCCCCCCCC~~~~",
    "~~~~~~~~CCCCCCCCCCCCCC~~~~~~~~~~~~~~~~~~~~~~~~~~~~~..FF.FF...................M..~~~~~~~~~~~~~~~~~~~~~~~~~~~~CCCCCCCCCCCCCCCC~~~~",
    "~~~~~~~~CCCCCCCCCCCCC~~~~~~~~~~~~~~~~~~~~~~~~~~~~~F.FF..FF............F..F.M....~~~~~~~~~~~~~~~~~~~~~~~~~~~~~CCCCCCCCCCCCCCC~~~~",
    "~~~~~~~~CCCCCCCCCCCCC~~~~~~~~~~~~~~~~~~~~~~~~~~~~~F......FF.............F.M..F...~~~~~~~~~~~~~~~~~~~~~~~~~~~~CCCCCCCCCCCCC~~~~~~",
    "~~~~~~~~~~CCCCCCCCC~~~~~~~~~~~~~~~~~~~~~~~~~~~~~~~~.F....F.............F......F.~~~~~~~~~~~~~~~~~~~~~~~~~~~~~~CCCCCCCCCCC~~~~~~~",
    "~~~~~~~~~~~CCCCCCC~~~~~~~~~~~~~~~~~~~~~~~~~~~~~~~~FF.F.F..F.............F....FFF~~~~~~~~~~~~~~~~~~~~~~~~~~~~~~~CCCCCCCCC~~~~~~~~",
    "~~~~~~~~~~~~CCCCC~~~~~~~~~~~~~~~~~~~~~~~~~~~~~~~~~~......F............F..F.FF..~~~~~~~~~~~~~~~~~~~~~~~~~~~~~~~~~~CCC~~~~~~~~~~~~",
    "~~~~~~~~~~~~~~~~~~~~~~~~~~~~~~~~~~~~~~~~~~~~~~~~~~~......FF...F...M...F....F...~~~~~~~~~~~~~~~~~~~~~~~~~~~~~~~~~~~~~~~~~~~~~~~~~",
    "~~~~~~~~~~~~~~~~~~~~~~~~~~~~~~~~~~~~~~~~~~~~~~~~~~~.F......F.F..F.....F.......~~~~~~~~~~~~~~~~~~~~~~~~~~~~~~~~~~~~~~~~~~~~~~~~~~",
    "~~~~~~~~~~~~~~~~~~~~~~~~~~~~~~~~~~~~~~~~~~~~~~~~~~~.....F...FF..........F...F~~~~~~~~~~~~~~~~~~~~~CCCCCCC~~~~~~~~~~~~~~~~~~~~~~~",
    "~~~~~~~~~~~~~~~~~~~~~~~~~~~~C~CC~~~~~~~~~~~~~~~~~~~~..F..F.FM....F...F......F~~~~~~~~~~~~~~~~~~~~~CCCCCCCCCCCCC~~~~~~~~~~~~~~~~~",
    "~~~~~~~~~~~~~~~~~~~~~~~~~CCCCCCCC~~~~~~~~~~~~~~~~~~~.F.....F.......M......F~~~~~~~~~~~~CCCCCCCCCCCCCCCCCCCCCCCCCC~~~~~~~~~~~~~~~",
    "~~~~~~~~~~~~~~~~~~~CCCCCCCCCCCCCCCC~~~~~~~~~~~~~~~~~~~~~.....F.F...~~~M...~~~~~~~~~~~~CCCCCCCCCCCCCCCCCCCCCCCCCCCC~~~~~~~~~~~~~~",
    "~~~~~~~~~~~~~~~~~~CCCCCCCCCCCCCCCCCC~~~~~~~~~~~~~~~~~~~~~~~~~~~.~~~~~~~~~~~~~~~~~~~~~CCCCCCCCCCCCCCCCCCCCCCCCCCCCCC~~~~~~~~~~~~~",
    "~~~~~~~~~~~~~~~~CCCCCCCCCCCCCCCCCCCCC~~~~~~~~~~~~~~~~~~~~~~~~~~~~~~~~~~~~~~~~~~~~~~~CCCCCCCCCCCCCCCCCCCCCCCCCCCCCCC~~~~~~~~~~~~~",
    "~~~~~~~~~~~~~CCCCCCCCCCCCCCCCCCCCCCCCCCC~~~~~~~~~~~~~~~~~~~~~~~~~~~~~~~~~~~~~~~~~~CCCCCCCCCCCCCCCCCCCCCCCCCCCCCCCCCC~~~~~~~~~~~~",
    "~~~~~~~~CCCCCCCCCCCCCCCCCCCCCCCCCCCCCCCCCC~~~~~~~~~~~~~~~~~~~~~~~~~~~~~~~~~~~~~~~CCCCCCCCCCCCCCCCCCCCCCCCCCCCCCCCCCC~~~~~~~~~~~~",
    "~~~~~~CCCCCCCCCCCCCCCCCCCCCCCCCCCCCCCCCCCCC~~~~~~~~~~~~~~~~~~~~~~~~~~~~~~~~~~~~CCCCCCCCCCCCCCCCCCCCCCCCCCCCCCCCCCCCC~~~~~~~~~~~~",
    "~~~~~CCCCCCCCCCCCCCCCCCCCCCCCCCCCCCCCCCCCCCC~~~~~~~~~~~~~~~~~~~~~~~~~~~~~~~~~~~CCCCCCCCCCCCCCCCCCCCCCCCCCCCCCCCCCCCC~~~~~~~~~~~~",
    "~~~~CCCCCCCCCCCCCCCCCCCCCCCCCCCCCCCCCCCCCCCCC~~~~~~~~~~~~~~~~~~~~~~~~~~~~~~~~~CCCCCCCCCCCCCCCCCCCCCCCCCCCCCCCCCCCCCCC~~~~~~~~~~~",
    "~~~CCCCCCCCCCCCCCCCCCCCCCCCCCCCCCCCCCCCCCCCCC~~~~~~~~~~~~~~~~~~~~~~~~~~~~~~~~~CCCCCCCCCCCCCCCCCCCCCCCCCCCCCCCCCCCCCCC~~~~~~~~~~~",
    "~~~CCCCCCCCCCCCCCCCCCCCCCCCCCCCCCCCCCCCCCCCCC~~~~~~~~~~~~~~~~~~~~~~~~~~~~~~~~CCCCCCCCCCCCCCCCCCCCCCCCCCCCCCCCCCCCCCCC~~~~~~~~~~~",
    "~~~CCCCCCCCCCCCCCCCCCCCCCCCCCCCCCCCCCCCCCCCCC~~~~~~~~~~~~~~~~~~~~~~~~~CCC~~~~CCCCCCCCCCCCCCCCCCCCCCCCCCCCCCCCCCCCCCCC~~~~~~~~~~~",
    "~~~CCCCCCCCCCCCCCCCCCCCCCCCCCCCCCCCCCCCCCCCCC~~~~~~~~~~~~~~~~CCCCCCCCCCCCCCCC~CCCCCCCCCCCCCCCCCCCCCCCCCCCCCCCCCCCCCCCC~~~~~~~~~~",
    "~~~~CCCCCCCCCCCCCCCCCCCCCCCCCCCCCCCCCCCCCCCC~~~~~~~~~~~~~~CCCCCCCCCCCCCCCCCCCCCCCCCCCCCCCCCCCCCCCCCCCCCCCCCCCCCCCCCCCC~~~~~~~~~~",
    "~~~CCCCCCCCCCCCCCCCCCCCCCCCCCCCCCCCCCCCCCCCC~~~~~~~~~~~~CCCCCCCCCCCCCCCCCCCCCCCCCCCCCCCCCCCCCCCCCCCCCCCCCCCCCCCCCCCCC~~~~~~~~~~~",
    "~~~~CCCCCCCCCCCCCCCCCCCCCCCCCCCCCCCCCCCCCCCC~~~~~~~~~~CCCCCCCCCCCCCCCCCCCCCCCCCCCCCCCCCCCCCCCCCCCCCCCCCCCCCCCCCCCCCCCC~~~~~~~~~~",
    "~~~~~CCCCCCCCCCCCCCCCCCCCCCCCCCCCCCCCCCCCCC~~~~~~~~~~CCCCCCCCCCCCCCCCCCCCCCCCCCCCCCCCCCCCCCCCCCCCCCCCCCCCCCCCCCCCCCCC~~~~~~~~~~~",
    "~~~~~~CCCCCCCCCCCCCCCCCCCCCCCCCCCCCCCCCCCCC~~~~~~~~~~CCCCCCCCCCCCCCCCCCCCCCCCCCCCC~CCCCCCCCCCCCCCCCCCCCCCCCCCCCCCCCC~~~~~~~~~~~~",
    "~~~~~~~CCCCCCCCCCCCCCCCCCCCCCCCCCCCCCCCCCC~~~~~~~~~~~~CCCCCCCCCCCCCCCCCCCCCCCCCCC~~~~~CCCCCCCCCCCCCCCCCCCCCCCCCCCCC~~~~~~~~~~~~~",
    "~~~~~~~CCCCCCCCCCCCCCCCCCCCCCCCCCCCCCCCCCCC~~~~~~~~~~~CCCCCCCCCCCCCCCCCCCCCCCCCCC~~~~~~~CCCCCCCCCCCCCCCCCCCCCCCC~~~~~~~~~~~~~~~~",
    "~~~~~~~~~CCCCCCCCCCCCCCCCCCCCCCCCCCCCCCCCC~~~~~~~~~~~~~CCCCCCCCCCCCCCCCCCCCCCCCC~~~~~~~~~~~CCCCCCCCCCCCCCCCCCCC~~~~~~~~~~~~~~~~~",
    "~~~~~~~~~~CCCCCCCCCCCCCCCCCCCCCCCCCCCCCCC~~~~~~~~~~~~~~~~CCCCCCCCCCCCCCCCCCCCCCC~~~~~~~~~~~~C~C~C~~CCCCCCCCCC~~~~~~~~~~~~~~~~~~~",
    "~~~~~~~~~~~~CCCCCCCCCCCCCCCCCCCCCCCCCCCC~~~~~~~~~~~~~~~~~~~CCCCCCCCCCCCCCCCCCCC~~~~~~~~~~~~~~~~~~~~~CCCCCCC~~~~~~~~~~~~~~~~~~~~~",
    "~~~~~~~~~~~~~~~~~~~~~~~CCCCCCCCCCCCCCC~~~~~~~~~~~~~~~~~~~~~~CCCCCCCCCCCCCCCCCC~~~~~~~~~~~~~~~~~~~~~~~~~CC~~~~~~~~~~~~~~~~~~~~~~~",
    "~~~~~~~~~~~~~~~~~~~~~~~~~CCCC~~~~~~~~~~~~~~~~~~~~~~~~~~~~~~~~~CCCCCCCCCCCCC~~~~~~~~~~~~~~~~~~~~~~~~~~~~~~~~~~~~~~~~~~~~~~~~~~~~~",
    "~~~~~~~~~~~~~~~~~~~~~~~~~~~~~~~~~~~~~~~~~~~~~~~~~~~~~~~~~~~~~~~~~~~CCCCC~~~~~~~~~~~~~~~~~~~~~~~~~~~~~~~~~~~~~~~~~~~~~~~~~~~~~~~~",
    "~~~~~~~~~~~~~~~~~~~~~~~~~~~~~~~~~~~~~~~~~~~~~~~~~~~~~~~~~~~~~~~~~~~~~~~~~~~~~~~~~~~~~~~~~~~~~~~~~~~~~~~~~~~~~~~~~~~~~~~~~~~~~~~~",
    "~~~~~~~~~~~~~~~~~~~~~~~~~~~~~~~~~~~~~~~~~~~~~~~~~~~~~~~~~~~~~~~~~~~~~~~~~~~~~~~~~~~~~~~~~~~~~~~~~~~~~~~~~~~~~~~~~~~~~~~~~~~~~~~~",
    "~~~~~~~~~~~~~~~~~~~~~~~~~~~~~~~~~~~~~~~~~~~~~~~~~~~~~~~~~~~~~~~~~~~~~~~~~~~~~~~~~~~~~~~~~~~~~~~~~~~~~~~~~~~~~~~~~~~~~~~~~~~~~~~~",
    "~~~~~~~~~~~~~~~~~~~~~~~~~~~~~~~~~~~~~~~~~~~~~~~~~~~~~~~~~~~~~~~~~~~~~~~~~~~~~~~~~~~~~~~~~~~~~~~~~~~~~~~~~~~~~~~~~~~~~~~~~~~~~~~~",
    "~~~~~~~~~~~~~~~~~~~~~~~~~~~~~~~~~~~~~~~~~~~~~~~~~~~~~~~~~~~~~~~~~~~~~~~~~~~~~~~~~~~~~~~~~~~~~~~~~~~~~~~~~~~~~~~~~~~~~~~~~~~~~~~~",
    "~~~~~~~~~~~~~~~~~~~~~~~~~~~~~~~~~~~~~~~~~~~~~~~~~~~~~~~~~~~~~~~~~~~~~~~~~~~~~~~~~~~~~~~~~~~~~~~~~~~~~~~~~~~~~~~~~~~~~~~~~~~~~~~~"
  ],
  "hiddenRows": [
    "~~~~~~~~~~~~~~~~~~~~~~~~~~~~~~~~~~~~~~~~~~~~~~~~~~~~~~~~~~~~~~~~~~~~~~~~~~~~~~~~~~~~~~~~~~~~~~~~~~~~~~~~~~~~~~~~~~~~~~~~~~~~~~~~",
    "~~~~~~~~~~~~~~~~~~~~~~~~~~~~~~~~~~~~~~~~~~~~~~~~~~~~~~~~~~~~~~~~~~~~~~~~~~~~~~~~~~~~~~~~~~~~~~~~~~~~~~~~~~~~~~~~~~~~~~~~~~~~~~~~",
    "~~~~~~~~~~~~~~~~~~~~~~~~~~~~~~~~~~~~~~~~~~~~~~~~~~~~~~~~~~~~~~~~~~~~~~~~~~~~~~~~~~~~~~~~~~~~~~~~~~~~~~~~~~~~~~~~~~~~~~~~~~~~~~~~",
    "~~~~~~~~~~~~~~~~~~~~~~~~~~~~~~~~~~~~~~~~~~~~~~~~~~~~~~~~~~~~~~~~~~~~~~~~~~~~~~~~~~~~~~~~~~~~~~~~~~~~~~~~~~~~~~~~~~~~~~~~~~~~~~~~",
    "~~~~~~~~~~~~~~~~~~~~~~~~~~~~~~~~~~~~~~~~~~~~~~~~~~~~~~~~~~~~~~~~~~~~~~~~~~~~~~~~~~~~~~~~~~~~~~~~~~~~~~~~~~~~~~~~~~~~~~~~~~~~~~~~",
    "~~~~~~~~~~~~~~~~~~~~~~~~~~~~~~~~~~~~~~~~~~~~~~~~~~~~~~~~~~~~~~~~~~~~~~~~~~~~~~~~~~~~~~~~~~~~~~~~~~~~~~~~~~~~~~~~~~~~~~~~~~~~~~~~",
    "~~~~~~~~~~~~~~~~~~~~~~~~~~~~~~~~~~~~~~~~~~~~~~~~~~~~~~~~~~~~~~~~~~~~~~~~~~~~~~~~~~~~~~~~~~~~~~~~~~F~~~~~~~~~~~~~~~~~~~~~~~~~~~~~",
    "~~~~~~~~~~~~~~~~~~~~~~~~~~~~~~~~~~~~~~~~~~~~~~~~~~~~~~~~~~~~~~~~~~~~~~~~~~~~~~~~~~~~~~~~~~~~~~~...FF.~.~~~~~~~~~~~~~~~~~~~~~~~~~",
    "~~~~~~~~~~~~~~~~~~~~~~~~~~~~~~~~~~~~~~~~~~~~~~~~~~~~~~~~~~~~~~~~~~...~~~~~~~~~~~~~~~~~~~~~~~~~.F....F.F....F~~~~~~~~~~~~~~~~~~~~",
    "~~~~~~~~~~~~~~~~~~~~~~~~~~~~~~~~~~~~~~~~~~~~~~~~~~~~~~~~~~~~FM....FF.F~~~~~~~~~~~~~~~~~~~~~~.........MF...F.F~~~~~~~~~~~~~~~~~~~",
    "~~~~~~~~~~~~~~~~~~~~~~~~~~~~~~~~.~~~~~~~~~~~~~~~~~~~~~~......F.........~~~~~~~~~~~~~~~..FFF....M....FM..M..F..~~~~~~~~~~~~~~~~~~",
    "~~~~~~~~~~~~~~~~~~~~~~~~~~~~~.MM...~~~~~~~~~~~~~~~~~~~......FF.....F..M.~~~~~~~~~~~~~FF...FM....M.....F..FF...~~~~~~~~~~~~~~~~~~",
    "~~~~~~~~~~~~~~~~~~~~~~~..FF....M..M.~~~~~~~~~~~~~~~~~~........F....F..FM.~~~~~~~~~~~.MF......FFF...FF..M...FF.~~~~~~~~~~~~~~~~~~",
    "~~~~~~~~~~~~~~~~~~~~~~.M..F.M.FF.F......~~~~~~~~~~~~~.......F.....F.F..FF~~~~~~~~~~..F...F...M.....FM....F.....~~~~~~~~~~~~~~~~~",
    "~~~~~~~~~~~~~~~~~~~~~..M...FF...FF.FFM.MF.~~~~~~~~~~~........F.....F..FFF~~~~~~~~~M.F.MM.M...F....F.M.....F.....M~~~~~~~~~~~~~~~",
    "~~~~~~~~~~~~~~~~~~~FM..MFM...F..F..F.....F..~~~~~~~~~~...............F.F.~~~~~~~~~FMF.....M.F..M......FF...MF...M.~~~~~~~~~~~~~~",
    "~~~~~~~~~~~~~~~~~.F......M..FF.........FF..F.~~~~~~~~~......F..FF.F..F..~~~~~~~~~..M.MFFFM...F.F.FM.M.........M..M.~~~~~~~~~~~~~",
    "~~~~~~~~~~~~~~~...F..F...FFM.M.....F....FMFFM~~~~~~~~~...........F....~~~~~~~~~~~..M...M.M..M.......F...F..F....M.M.~~~~~~~~~~~~",
    "~~~~~~~~~~~~~~FF...M.M.M.F...MF..F.....F..M.FF~~~~~~~~~~FFFM.........F~~~~~~~~~~~..F...........F..F.....MF....FFFF..F~~~~~~~~~~~",
    "~~~~~~~~~~~~~F..........FF........M...FF.M...F~~~~~~~~~~~~~~F..M.F...~~~~~~~~~~~...FFFFFF.....M..MMM.FF...FF.FF....F~~~~~~~~~~~~",
    "~~~~~~~~~~~~~F...F....FF..........F...F.F.....~~~~~~~~~~~~~~~~....M~~~~~~~~~~~~~FF....FF.F..M.FFM..MF.FMF.F.F..F....F~~~~~~~~~~~",
    "~~~~~~~~~~~~~FFFF....F.FM.....FM...F....F....F.~~~~~~~~~~~~~~~~~~~~~~~~~~~~~~~~~F...F..FFF...M.......F.F.F....FFF.F..~~~~~~~~~~~",
    "~~~~~~~~~~~~~F...F.FF....M......FM..F.FFFF...FF~~~~~~~~~~~~~~~~~~~~~~~~~~~~~~~~~...F.....F.FF...M..FF..FF.M...F.F...~~~~~~~~~~~~",
    "~~~~~~~~~~~~~F...FFF.F..F.......FF..MF...F..F..~~~~~~~~~~~~~~~~~~~~~~~~~~~~~~~~~F......F.F..M....M...M.F.M.F.F.....~~~~~~~~~~~~~",
    "~~~~~~~~~~~~~~F.FFF..F.F.M.F.FMF.M..F...F...FF.~~~~~~~~~~~~~~~~~~~~~~~~~~~~~~~~~~...F....F....M..FFM.M......F.....~~~~~~~~~~~~~~",
    "~~~~~~~~~~~~~~~.F.....F..F........FF...FFFF.F.~~~~~~~~~~~~~~~~~~~~~~~~~~~~~~~~~~~~..F....F.MF.M.F...M........F...~~~~~~~~~~~~~~~",
    "~~~~~~~~~~~~~~~~~F....FF.F...FF..M..F..F....F.~~~~~~~~~~~~~~~~~~~~~~~~~~~~~~~~~~~~~~..F......F.M..MM.M...M..F..~~~~~~~~~~~~~~~~~",
    "~~~~~~~~~~~~~~~~~~~.FFF.....M......FM.F..F..~~~~~~~~~~~~~~~~~~~~~~~~~~~~~~~~~~~~~~~~~~~~~~....FM..MM..MM......~~~~~~~~~~~~~~~~~~",
    "~~~~~~~~~~~~~~~~~~~~~....F.M~~.....M.FF.~~~~~~~~~~~~~~~~~~~~~~~~~~~~~~~~~~~~~~~~~~~~~~~~~~~~~..M..~~.....F...~~~~~~~~~~~~~~~~~~~",
    "~~~~~~~~~~~~~~~~~~~~~~~F~~~~~~~~~~~~~~~~~~~~~~~~~~~~~~~~~~~~~.~~~~~~~~~~~~~~~~~~~~~~~~~~~~~~~~~~~~~~~~~~.F~~~~~~~~~~~~~~~~~~~~~~",
    "~~~~~~~~~~~~~~~~~~~~~~~~~~~~~~~~~~~~~~~~~~~~~~~~~~~~~~~~~~~....F..~~~~~~~~~~~~~~~~~~~~~~~~~~~~~~~~~~~~~~~~~~~~~~~~~~~~~~~~~~~~~~",
    "~~~~~~~~~~~~~~~~~~~~~~~~~~~~~~~~~~~~~~~~~~~~~~~~~~~~~~~~~~FFF.....MMF.~~~~~~~~~~~~~~~~~~~~~~~~~~~~~~~~~~~~~~~~~~~~~~~~~~~~~~~~~~",
    "~~~~~~~~~~~~~~~~~~~~~~~~~~~~~~~~~~~~~~~~~~~~~~~~~~~~~~~~~F.F.F.F..F.FF..~~~~~~~~~~~~~~~~~~~~~~~~~~~~~~~~~~~~~~~~~~~~~~~~~~~~~~~~",
    "~~~~~~~~~~~~~~~~~~~~~~~~~~~~~~~~~~~~~~~~~~~~~~~~~~~~~~~~.FFFFF..........~~~~~~~~~~~~~~~~~~~~~~~~~~~~~~~~~~~~~~~~~..~~~~~~~~~~~~~",
    "~~~~~~~~~..F........~~~~~~~~~~~~~~~~~~~~~~~~~~~~~~~~~.....MM.F....F..F....~~~~~~~~~~~~~~~~~~~~~~~~~~~~~~~~~~~~....M.....~~~~~~~~",
    "~~~~~~~~..F........F.~~~~~~~~~~~~~~~~~~~~~~~~~~~~~~~.FF.....MF....F.......F..~~~~~~~~~~~~~~~~~~~~~~~~~~~~~~~..............~~~~~~",
    "~~~~~~~~..F.......M..~~~~~~~~~~~~~~~~~~~~~~~~~~~~~~.F.FF.....M...FFF.....F....~~~~~~~~~~~~~~~~~~~~~~~~~~~~~~.M.F....F...F...~~~~",
    "~~~~~~~~...F.........~~~~~~~~~~~~~~~~~~~~~~~~~~~~~...F..FM.....................~~~~~~~~~~~~~~~~~~~~~~~~~~~~~...........FF.F.~~~~",
    "~~~~~~~~..FM.F...F.F..~~~~~~~~~~~~~~~~~~~~~~~~~~~~~..FF.FF...................M..~~~~~~~~~~~~~~~~~~~~~~~~~~~~.........F...F..~~~~",
    "~~~~~~~~....F........~~~~~~~~~~~~~~~~~~~~~~~~~~~~~F.FF..FF............F..F.M....~~~~~~~~~~~~~~~~~~~~~~~~~~~~~.F...FF....F...~~~~",
    "~~~~~~~~.FF..M....F..~~~~~~~~~~~~~~~~~~~~~~~~~~~~~F......FF.............F.M..F...~~~~~~~~~~~~~~~~~~~~~~~~~~~~..F.....M....~~~~~~",
    "~~~~~~~~~~.FF.F..M.~~~~~~~~~~~~~~~~~~~~~~~~~~~~~~~~.F....F.............F......F.~~~~~~~~~~~~~~~~~~~~~~~~~~~~~~.......F...~~~~~~~",
    "~~~~~~~~~~~......M~~~~~~~~~~~~~~~~~~~~~~~~~~~~~~~~FF.F.F..F.............F....FFF~~~~~~~~~~~~~~~~~~~~~~~~~~~~~~~F...M....~~~~~~~~",
    "~~~~~~~~~~~~.....~~~~~~~~~~~~~~~~~~~~~~~~~~~~~~~~~~......F............F..F.FF..~~~~~~~~~~~~~~~~~~~~~~~~~~~~~~~~~~..F~~~~~~~~~~~~",
    "~~~~~~~~~~~~~~~~~~~~~~~~~~~~~~~~~~~~~~~~~~~~~~~~~~~......FF...F...M...F....F...~~~~~~~~~~~~~~~~~~~~~~~~~~~~~~~~~~~~~~~~~~~~~~~~~",
    "~~~~~~~~~~~~~~~~~~~~~~~~~~~~~~~~~~~~~~~~~~~~~~~~~~~.F......F.F..F.....F.......~~~~~~~~~~~~~~~~~~~~~~~~~~~~~~~~~~~~~~~~~~~~~~~~~~",
    "~~~~~~~~~~~~~~~~~~~~~~~~~~~~~~~~~~~~~~~~~~~~~~~~~~~.....F...FF..........F...F~~~~~~~~~~~~~~~~~~~~~M..F...~~~~~~~~~~~~~~~~~~~~~~~",
    "~~~~~~~~~~~~~~~~~~~~~~~~~~~~.~.M~~~~~~~~~~~~~~~~~~~~..F..F.FM....F...F......F~~~~~~~~~~~~~~~~~~~~~..F.....MF..M~~~~~~~~~~~~~~~~~",
    "~~~~~~~~~~~~~~~~~~~~~~~~~..FF....~~~~~~~~~~~~~~~~~~~.F.....F.......M......F~~~~~~~~~~~~.F..FM.M.........MFM.M..F.~~~~~~~~~~~~~~~",
    "~~~~~~~~~~~~~~~~~~~..MF..MM.F.MF...~~~~~~~~~~~~~~~~~~~~~.....F.F...~~~M...~~~~~~~~~~~~..M....F.F.M....FM..F...F...~~~~~~~~~~~~~~",
    "~~~~~~~~~~~~~~~~~~FFF.F.MFMFF.F.F...~~~~~~~~~~~~~~~~~~~~~~~~~~~.~~~~~~~~~~~~~~~~~~~~~.M.FF....MF..FF..FFF.FMF..MF.M~~~~~~~~~~~~~",
    "~~~~~~~~~~~~~~~~......F.......F......~~~~~~~~~~~~~~~~~~~~~~~~~~~~~~~~~~~~~~~~~~~~~~~MF..M.F.MF.M.F.......M..F..F...~~~~~~~~~~~~~",
    "~~~~~~~~~~~~~.F...F..F...FF...F.F.FF..F.~~~~~~~~~~~~~~~~~~~~~~~~~~~~~~~~~~~~~~~~~~M.M..M.M.......F....MFM.M..M..M.MF~~~~~~~~~~~~",
    "~~~~~~~~M....F.F..FF..F.M.............M..F~~~~~~~~~~~~~~~~~~~~~~~~~~~~~~~~~~~~~~~...F...........F....MFM...F....M...~~~~~~~~~~~~",
    "~~~~~~.FF.FFFFF..FFF....F....F....F...F.F..~~~~~~~~~~~~~~~~~~~~~~~~~~~~~~~~~~~~.F.M.M.FM..F..M..MM...F..M.F.F.......~~~~~~~~~~~~",
    "~~~~~F....MF....M.F.MFF.....F..FM.......F.M.~~~~~~~~~~~~~~~~~~~~~~~~~~~~~~~~~~~........M.M..F......FMF..M.....MMM...~~~~~~~~~~~~",
    "~~~~F..FF..M.F......F..FF......F.M..F...FF...~~~~~~~~~~~~~~~~~~~~~~~~~~~~~~~~~MF..M........M.F........M..F.FMF...M...~~~~~~~~~~~",
    "~~~MF....F.FM.F.....F...F.FM.MFFF.F.FF....F..~~~~~~~~~~~~~~~~~~~~~~~~~~~~~~~~~............M.MF.MM.MMMF..M..M.F.....F.~~~~~~~~~~~",
    "~~~........M.F..F....F.MF...F....F.......M...~~~~~~~~~~~~~~~~~~~~~~~~~~~~~~~~.F...............M.........F.M.F..FF...F~~~~~~~~~~~",
    "~~~.MF.F..F....MF.....F.F.................F..~~~~~~~~~~~~~~~~~~~~~~~~~.FF~~~~.F...F.....F.F.M.......F.F.FM...F...F...~~~~~~~~~~~",
    "~~~..FF...F.FF..FF..MFFFF..FM..F......F..FF..~~~~~~~~~~~~~~~~F.....F.........~FF.F....F..F..F..MM...MM....F.FFF...FFF.~~~~~~~~~~",
    "~~~~.F.F..FF.F...........F.F..FF.F.FF.F.....~~~~~~~~~~~~~~FF..F..M.F...M...F......F.F..F.F.FF..........M..FM.F..FF....~~~~~~~~~~",
    "~~~F.F.F.....F.FF...F.M....M...FMF..FFF.F...~~~~~~~~~~~~.F.....M.MF....F.F...F..M....F.FF...F............MMF.........~~~~~~~~~~~",
    "~~~~FF.F.F...F..M...F.M.....F...M.F..FF.FF..~~~~~~~~~~....F..M..........F...FFM.F......FF........F.......M..F.........~~~~~~~~~~",
    "~~~~~..F.FF.......MMF.M..F....F......FF..F.~~~~~~~~~~.M.M...F........FMFF..F...F.....F..FFF...F..FFFFM.......F...F...~~~~~~~~~~~",
    "~~~~~~.F.F.......MFF.........FM....F.F..F..~~~~~~~~~~F..M.F..F...F.....F.F........~F........M......FM.FF.......F.F..~~~~~~~~~~~~",
    "~~~~~~~...F.F...F...MF.........M.FFFFF..FF~~~~~~~~~~~~FF....FF....FFFM..M....F.F.~~~~~....F.......F..F..FF...FF....~~~~~~~~~~~~~",
    "~~~~~~~....FF......FF.M...FFFM..FFF...FF...~~~~~~~~~~~..F..F..M..FF....FM.F..F..F~~~~~~~...F.FF....M.......F..F.~~~~~~~~~~~~~~~~",
    "~~~~~~~~~......F..FMF.FF...F..FFM.F.....F.~~~~~~~~~~~~~FF..F....M..F..F..F......~~~~~~~~~~~.F..M.......M..M.F.F~~~~~~~~~~~~~~~~~",
    "~~~~~~~~~~FF..F.............M..F.......FF~~~~~~~~~~~~~~~~..FFF..M............F..~~~~~~~~~~~~.~F~.~~.F...F....~~~~~~~~~~~~~~~~~~~",
    "~~~~~~~~~~~~....M.F.F....F.......F....FF~~~~~~~~~~~~~~~~~~~.........MMF........~~~~~~~~~~~~~~~~~~~~~.FF..MM~~~~~~~~~~~~~~~~~~~~~",
    "~~~~~~~~~~~~~~~~~~~~~~~F.....F...F..FF~~~~~~~~~~~~~~~~~~~~~~...F.M.MF..F..F...~~~~~~~~~~~~~~~~~~~~~~~~~..~~~~~~~~~~~~~~~~~~~~~~~",
    "~~~~~~~~~~~~~~~~~~~~~~~~~.F..~~~~~~~~~~~~~~~~~~~~~~~~~~~~~~~~~F..MFFF....F.~~~~~~~~~~~~~~~~~~~~~~~~~~~~~~~~~~~~~~~~~~~~~~~~~~~~~",
    "~~~~~~~~~~~~~~~~~~~~~~~~~~~~~~~~~~~~~~~~~~~~~~~~~~~~~~~~~~~~~~~~~~~.....~~~~~~~~~~~~~~~~~~~~~~~~~~~~~~~~~~~~~~~~~~~~~~~~~~~~~~~~",
    "~~~~~~~~~~~~~~~~~~~~~~~~~~~~~~~~~~~~~~~~~~~~~~~~~~~~~~~~~~~~~~~~~~~~~~~~~~~~~~~~~~~~~~~~~~~~~~~~~~~~~~~~~~~~~~~~~~~~~~~~~~~~~~~~",
    "~~~~~~~~~~~~~~~~~~~~~~~~~~~~~~~~~~~~~~~~~~~~~~~~~~~~~~~~~~~~~~~~~~~~~~~~~~~~~~~~~~~~~~~~~~~~~~~~~~~~~~~~~~~~~~~~~~~~~~~~~~~~~~~~",
    "~~~~~~~~~~~~~~~~~~~~~~~~~~~~~~~~~~~~~~~~~~~~~~~~~~~~~~~~~~~~~~~~~~~~~~~~~~~~~~~~~~~~~~~~~~~~~~~~~~~~~~~~~~~~~~~~~~~~~~~~~~~~~~~~",
    "~~~~~~~~~~~~~~~~~~~~~~~~~~~~~~~~~~~~~~~~~~~~~~~~~~~~~~~~~~~~~~~~~~~~~~~~~~~~~~~~~~~~~~~~~~~~~~~~~~~~~~~~~~~~~~~~~~~~~~~~~~~~~~~~",
    "~~~~~~~~~~~~~~~~~~~~~~~~~~~~~~~~~~~~~~~~~~~~~~~~~~~~~~~~~~~~~~~~~~~~~~~~~~~~~~~~~~~~~~~~~~~~~~~~~~~~~~~~~~~~~~~~~~~~~~~~~~~~~~~~",
    "~~~~~~~~~~~~~~~~~~~~~~~~~~~~~~~~~~~~~~~~~~~~~~~~~~~~~~~~~~~~~~~~~~~~~~~~~~~~~~~~~~~~~~~~~~~~~~~~~~~~~~~~~~~~~~~~~~~~~~~~~~~~~~~~"
  ]
}