{
  "version": 1,
  "id": "archipelago_default",
  "name": "Arcipelago iniziale",
  "width": 64,
  "height": 40,
  "legend": {
    "~": "Water",
    ".": "Land",
    "F": "Forest",
    "M": "Mountain",
    "C": "Cloud"
  },
  "rows": [
    "~~~~~~~~~~~~~~~~~~~~~~~~~~~~~~~~~~~~~~~~~~~~~~~~~~~~~~~~~~~~~~~~",
    "~~~~~~~~~~~~~~~~~~~~~~~~~~~~~~~~~~~~~~~~~~~~~~~~~~~~~~~~~~~~~~~~",
    "~~~~~~~~~~~~~~~~~~~~~~~~~~~~~~~~~~~~~~~~~~~~~~~~~~~~~~~~~~~~~~~~",
    "~~~~~~~~~~~~~~~~~~~~~~~~~~~~~~~~~~~~CCCC~~~~~~~~~~~~~~~~~~~~~~~~",
    "~~~~~~~~~~~~~~~~~~~~~~~~~~~~~~~~~~CCCCCCCC~~~~~~~~~~~~~~~~~~~~~~",
    "~~~~~~~~~~~~~~~~~~~~~~~~~~~~~~~~CCCCCCCCCCCCCC~~~~~~~~~~~~~~~~~~",
    "~~~~~~~~~~~F...~~~~~~~~~~~~~~~~CCCCCCCCCCCCCCCC~~~~~~~~~~~~~~~~~",
    "~~~~~~~~~FF.........~~~~~~~~CCCCCCCCCCCCCCCCCCCC~~~~~~~~~~~~~~~~",
    "~~~~~~~~FFF..........~~~~~~CCCCCCCCCCCCCCCCCCCCC~~~~~~~~~~~~~~~~",
    "~~~~~~~~............FF~~~~~CCCCCCCCCCCCCCCCCCCCCC~~~~~~~~~~~~~~~",
    "~~~~~~~.............FFF~~~~CCCCCCCCCCCCCCCCCCCCCCC~~~~~~~~~~~~~~",
    "~~~~~~....FFFFFF....FFFF~~~CCCCCCCCCCCCCCCCCCCCCCCC~~~~~~~~~~~~~",
    "~~~~~.....FFFFFFF.......F~~~CCCCCCCCCCCCCCCCCCCCCC~~~~~~~~~~~~~~",
    "~~~~~....FFFFFFFF........~~~~CCCCCCCCCCCCCCCCCCCC~~~~~~~~~~~~~~~",
    "~~~~FF....FFFFFF..........~~~~CCCCCCCCCCCCCCCCCC~~~~~~~~~~~~~~~~",
    "~~~~~FF...M..FF..........~~~~~~CCCCCCCCCCCCCC~~~~~~~~~~~~~~~~~~~",
    "~~~~~F..........M.......~~~~~~~~C~~CCCCCCCC~~~~~~~~~~~~~~~~~~~~~",
    "~~~~~~...........F.....~~~~~~~~~~~~~~CCCC~~~~~~~~~~~~~~~~~~~~~~~",
    "~~~~~~~........FFFFFFF~~~~~~~~~~~~~~~~~~~~~~~~~~~~~~~~~~~~~~~~~~",
    "~~~~~~~~~~~....FFFF~F~~~~~~~~~~~~~~~~~~~~~~~~~~~~~~~~~~~~~~~~~~~",
    "~~~~~~~~~~~~..FF~~~~~~~~~~~~~~~~~~~~~~~~~~~~~~~~~~~~~CC~~~~~~~~~",
    "~~~~~~~~~~~~~~~~~~~~~~~~~~~~~~~~~~~~~~~~~~~~~~CCCCCCCCCC~~~~~~~~",
    "~~~~~~~~~~~~~~~~~~~~~~~~~~~~~~~~~~~~~~~~~~~~CCCCCCCCCCCC~~~~~~~~",
    "~~~~~~~~~~~~~~~~~~~~~~~CCC~~~~~~~~~~~~~~~~~CCCCCCCCCCCCCCCCCC~~~",
    "~~~~~~~~~~~~~~~~~~~~~CCCCCC~~~C~~~~~~~~~~~CCCCCCCCCCCCCCCCCCC~~~",
    "~~~~~~~~~~~~~~~~~~~CCCCCCCCCCCCC~~~~~~~~~~CCCCCCCCCCCCCCCCCCC~~~",
    "~~~~~~~~~~~~~~~~~~~CCCCCCCCCCCCCC~~~~~~~~CCCCCCCCCCCCCCCCCCCC~~~",
    "~~~~~~~~~~~CCC~~~~CCCCCCCCCCCCCCCC~~~~~~~CCCCCCCCCCCCCCCCCCCC~~~",
    "~~~~~~~~~CCCCCC~~~CCCCCCCCCCCCCCCC~~~~~~~CCCCCCCCCCCCCCCCCCCC~~~",
    "~~~~~~~CCCCCCCCCCCCCCCCCCCCCCCCCCC~~~~~~~~CCCCCCCCCCCCCCCCCCC~~~",
    "~~~~~~CCCCCCCCCCCCCCCCCCCCCCCCCCCC~~~~~~~~~CCCCCCCCCCCCCCCCCC~~~",
    "~~~~~~CCCCCCCCCCCCCCCCCCCCCCCCCCCC~~~~~~~~~CCCCCCCCCCCCCCCC~~~~~",
    "~~~~~~CCCCCCCCCCCCCCCCCCCCCCCCCCC~~~~~~~~~~~CCCCCCCCCCCCCC~~~~~~",
    "~~~~~~CCCCCCCCCCC~CCCCCCCCCCCCC~~~~~~~~~~~~~~CCCCCCCCCCCC~~~~~~~",
    "~~~~~~~CCCCCCCCC~~~CCCCCCCCCC~~~~~~~~~~~~~~~~~~~~~~~CCC~~~~~~~~~",
    "~~~~~~~~~~~CC~~~~~~~~~~~CCCC~~~~~~~~~~~~~~~~~~~~~~~~~~~~~~~~~~~~",
    "~~~~~~~~~~~~~~~~~~~~~~~~~~~~~~~~~~~~~~~~~~~~~~~~~~~~~~~~~~~~~~~~",
    "~~~~~~~~~~~~~~~~~~~~~~~~~~~~~~~~~~~~~~~~~~~~~~~~~~~~~~~~~~~~~~~~",
    "~~~~~~~~~~~~~~~~~~~~~~~~~~~~~~~~~~~~~~~~~~~~~~~~~~~~~~~~~~~~~~~~",
    "~~~~~~~~~~~~~~~~~~~~~~~~~~~~~~~~~~~~~~~~~~~~~~~~~~~~~~~~~~~~~~~~"
  ],
  "hiddenRows": [
    "~~~~~~~~~~~~~~~~~~~~~~~~~~~~~~~~~~~~~~~~~~~~~~~~~~~~~~~~~~~~~~~~",
    "~~~~~~~~~~~~~~~~~~~~~~~~~~~~~~~~~~~~~~~~~~~~~~~~~~~~~~~~~~~~~~~~",
    "~~~~~~~~~~~~~~~~~~~~~~~~~~~~~~~~~~~~~~~~~~~~~~~~~~~~~~~~~~~~~~~~",
    "~~~~~~~~~~~~~~~~~~~~~~~~~~~~~~~~~~~~...F~~~~~~~~~~~~~~~~~~~~~~~~",
    "~~~~~~~~~~~~~~~~~~~~~~~~~~~~~~~~~~.....FFF~~~~~~~~~~~~~~~~~~~~~~",
    "~~~~~~~~~~~~~~~~~~~~~~~~~~~~~~~~FFFF..FFFFFFFF~~~~~~~~~~~~~~~~~~",
    "~~~~~~~~~~~F...~~~~~~~~~~~~~~~~FFFFFFMMMFFFFFFF~~~~~~~~~~~~~~~~~",
    "~~~~~~~~~FF.........~~~~~~~~FFFFFFFFFMMMMMM.FF..~~~~~~~~~~~~~~~~",
    "~~~~~~~~FFF..........~~~~~~FFFFFFFFF..MMMMM..FFF~~~~~~~~~~~~~~~~",
    "~~~~~~~~............FF~~~~~..FFFFFF..........FFFF~~~~~~~~~~~~~~~",
    "~~~~~~~.............FFF~~~~.................FFFFFF~~~~~~~~~~~~~~",
    "~~~~~~....FFFFFF....FFFF~~~.................FFFFFFF~~~~~~~~~~~~~",
    "~~~~~.....FFFFFFF.......F~~~.......MMMMM...FFFFFFF~~~~~~~~~~~~~~",
    "~~~~~....FFFFFFFF........~~~~.....MMMMMMFFF...FFF~~~~~~~~~~~~~~~",
    "~~~~FF....FFFFFF..........~~~~...FFFFMMMFF......~~~~~~~~~~~~~~~~",
    "~~~~~FF...M..FF..........~~~~~~.FFFFFFFFFF...~~~~~~~~~~~~~~~~~~~",
    "~~~~~F..........M.......~~~~~~~~.~~FFFFFF..~~~~~~~~~~~~~~~~~~~~~",
    "~~~~~~...........F.....~~~~~~~~~~~~~~..FF~~~~~~~~~~~~~~~~~~~~~~~",
    "~~~~~~~........FFFFFFF~~~~~~~~~~~~~~~~~~~~~~~~~~~~~~~~~~~~~~~~~~",
    "~~~~~~~~~~~....FFFF~F~~~~~~~~~~~~~~~~~~~~~~~~~~~~~~~~~~~~~~~~~~~",
    "~~~~~~~~~~~~..FF~~~~~~~~~~~~~~~~~~~~~~~~~~~~~~~~~~~~~F.~~~~~~~~~",
    "~~~~~~~~~~~~~~~~~~~~~~~~~~~~~~~~~~~~~~~~~~~~~~..........~~~~~~~~",
    "~~~~~~~~~~~~~~~~~~~~~~~~~~~~~~~~~~~~~~~~~~~~F...........~~~~~~~~",
    "~~~~~~~~~~~~~~~~~~~~~~~..F~~~~~~~~~~~~~~~~~F......MMM.FFFFF..~~~",
    "~~~~~~~~~~~~~~~~~~~~~....FF~~~F~~~~~~~~~~~......MMMMMMFFFFFFF~~~",
    "~~~~~~~~~~~~~~~~~~~.....FFFFFFFF~~~~~~~~~~.......MMMMMMFFFFFF~~~",
    "~~~~~~~~~~~~~~~~~~~FFFFMMMMMFFFFF~~~~~~~~...FFFFFMMMMFFFFFFF.~~~",
    "~~~~~~~~~~~...~~~~FFFFMMMMMM.FFF..~~~~~~~..FFFFFFF......FFF..~~~",
    "~~~~~~~~~....FF~~~FFFF.MMMMM...F..~~~~~~~.FFFFFFFF...........~~~",
    "~~~~~~~...M..FFFFFFFFF.........FFF~~~~~~~~.FFFFFFF...........~~~",
    "~~~~~~FFMMMM..FFFFFFF.........FFFF~~~~~~~~~..FFFMMM........FF~~~",
    "~~~~~~FFMMMM........FF........FFFF~~~~~~~~~.......MM......F~~~~~",
    "~~~~~~FFMMMM........FFFMF....FFFF~~~~~~~~~~~..............~~~~~~",
    "~~~~~~FFF........~..FFFFFFFFFFF~~~~~~~~~~~~~~....FFFFF...~~~~~~~",
    "~~~~~~~.........~~~FFFFFFFFF.~~~~~~~~~~~~~~~~~~~~~~~FFF~~~~~~~~~",
    "~~~~~~~~~~~..~~~~~~~~~~~FFFF~~~~~~~~~~~~~~~~~~~~~~~~~~~~~~~~~~~~",
    "~~~~~~~~~~~~~~~~~~~~~~~~~~~~~~~~~~~~~~~~~~~~~~~~~~~~~~~~~~~~~~~~",
    "~~~~~~~~~~~~~~~~~~~~~~~~~~~~~~~~~~~~~~~~~~~~~~~~~~~~~~~~~~~~~~~~",
    "~~~~~~~~~~~~~~~~~~~~~~~~~~~~~~~~~~~~~~~~~~~~~~~~~~~~~~~~~~~~~~~~",
    "~~~~~~~~~~~~~~~~~~~~~~~~~~~~~~~~~~~~~~~~~~~~~~~~~~~~~~~~~~~~~~~~"
  ]
}
